% % O % % % % % % % % %
% - - - - - - - - - - %
% - - - - - - - - - - %
% - - % % - - % % - - %
% - - % % - - % % - - %
% - - % % - - - - - - %
% - - % % - - - - - - %
% - - % % - - % % - - %
% - - % O - - % % - - %
% - - % % - - % % - - O
% - - % % - - % % - - %
% - - % % - - % % - - %
% - - - - - - % % - - %
% - - - - - - % % - - %
% % % % % % % % % % % %


15 x 12