% % O % % % % %
% - - - - - - %
% - - - - - - %
% - - % % - - %
% - - % % - - %
% - - % % - - %
% - - % % - - %
% - - % % - - %
% - - % % - - %
% - - % % - - %
% - - % % - - %
% - - - - - - %
% - - - - - - %
% % O % % % O %


14 x 8